{
  "13": {"en": "A"},
  "21": {"en": "B"},
  "8":  {"en": "C"},
  "15": {"en": "D"},
  "3":  {"en": "EURO"},
  "24": {"en": "F"},
  "9":  {"en": "G"},
  "4":  {"en": "H"},
  "18": {"en": "I"},
  "22": {"en": "J"},
  "10": {"en": "K"},
  "14": {"en": "L"},
  "6":  {"en": "M"},
  "11": {"en": "N"},
  "1":  {"en": "LADDER"},
  "16": {"en": "P"},
  "26": {"en": "Q"},
  "12": {"en": "R"},
  "20": {"en": "S"},
  "2":  {"en": "DOLLAR"},
  "5":  {"en": "U"},
  "7":  {"en": "V"},
  "23": {"en": "W"},
  "25": {"en": "X"},
  "19": {"en": "Y"},
  "17": {"en": "Z"}
}
